1 1

2
3 3
6 6

10
10
3 3 3 3 3 3 3 3 3 3
3 0 0 0 0 0 0 0 0 3
3 0 0 0 0 0 0 1 0 3
3 0 0 0 0 0 0 0 0 3
3 0 0 0 3 0 0 0 0 3
3 0 0 0 0 3 0 0 0 3
3 0 0 0 0 0 0 0 0 3
3 0 1 0 0 0 0 0 0 3
3 0 0 0 0 0 0 0 0 3
3 3 3 3 3 3 3 3 3 3
