1
1
2
3
3
6
6
10
10
3333333333
3000000003
3000000103
3000000003
3000300003
3000030003
3000000003
3010000003
3000000003
3333333333
