1 2

32
2 2
2 3
2 7
2 8
2 11
2 13
3 3
3 4
3 5
3 11
4 2
4 8
4 9
4 11
4 12
5 9
6 8
6 10
6 12
8 9
8 11
9 8
9 9
9 11
9 13
10 9
11 8
11 9
11 10
11 12
11 13
11 14

16 19
0 3 3 3 0 0 3 3 3 3 3 3 3 3 3 3 3 3 3
3 3 0 3 3 3 3 0 0 0 0 0 0 0 3 0 0 0 3
3 0 0 0 0 0 0 0 0 0 0 0 0 0 3 1 1 1 3
3 0 0 0 0 0 3 0 0 0 0 0 0 0 3 1 1 1 3
3 0 0 0 0 0 3 0 0 0 0 0 0 0 3 1 1 1 3
3 3 3 0 0 0 3 0 0 0 0 0 0 0 3 1 1 1 3
3 0 0 0 0 0 3 0 0 0 0 0 0 0 3 1 1 1 3
3 0 0 0 0 3 3 3 3 3 3 0 3 3 3 1 1 1 3
3 3 0 3 0 0 3 0 0 0 0 0 0 0 3 1 1 1 3
3 0 0 3 3 0 3 0 0 0 0 0 0 0 3 3 1 1 3
3 0 1 1 3 0 3 0 0 0 0 0 0 0 0 0 3 1 3
3 0 1 1 3 0 3 0 0 0 0 0 0 0 0 0 3 1 3
3 3 3 3 3 0 3 0 0 0 0 0 0 0 3 0 3 1 3
0 0 0 0 3 0 3 3 3 3 3 3 3 3 3 0 3 1 3
0 0 0 0 3 0 0 0 0 0 0 0 0 0 0 0 3 1 3
0 0 0 0 3 3 3 3 3 3 3 3 3 3 3 3 3 3 3
