2 7

14
2 11
3 10
4 5
4 7
4 8
5 5
6 5
6 7
6 8
7 5
7 12
8 11
8 12
9 8

15 19
0 0 0 0 0 0 0 0 0 0 3 3 3 3 0 0 0 0 0
0 0 0 0 0 3 3 3 3 0 3 0 0 3 0 0 0 0 0
0 0 0 3 3 3 0 0 3 3 3 0 0 3 0 0 0 0 0
0 0 3 3 0 0 0 0 0 0 0 0 0 3 0 0 0 0 0
0 3 3 0 0 0 0 0 0 3 3 0 3 3 0 0 0 0 0
0 3 0 0 3 0 3 3 0 0 0 0 0 3 0 0 0 0 0
0 3 0 3 0 0 0 0 0 0 3 0 3 3 3 0 0 0 0
0 3 0 0 0 0 0 3 0 0 3 0 0 0 3 3 3 3 3
3 3 3 3 0 0 0 0 3 0 0 0 0 0 3 0 0 0 3
3 3 3 3 0 3 3 0 0 0 0 0 0 0 0 0 0 0 3
3 1 0 0 0 0 3 3 3 0 0 3 3 3 3 3 3 3 3
3 1 1 0 1 1 3 0 3 3 3 3 0 0 0 0 0 0 0
3 1 1 1 3 1 3 0 0 0 0 0 0 0 0 0 0 0 0
3 1 1 1 1 1 3 0 0 0 0 0 0 0 0 0 0 0 0
3 3 3 3 3 3 3 0 0 0 0 0 0 0 0 0 0 0 0
