4 7

15
3 5
3 7
3 9
3 11
4 6
4 8
5 5
5 7
5 9
6 6
6 8
7 5
7 6
7 7
7 9

13 17
3 3 3 3 3 3 3 3 3 3 3 3 3 3 3 3 0
3 0 0 0 0 0 0 0 0 0 0 0 0 0 0 3 0
3 0 3 0 3 3 3 3 3 3 0 0 0 0 0 3 0
3 0 3 0 0 0 0 0 0 0 0 0 3 0 0 3 0
3 0 3 0 0 0 0 0 0 0 0 0 3 3 0 3 3
3 0 3 0 0 0 0 0 0 0 3 3 3 1 1 1 3
3 0 3 0 0 0 0 0 0 0 0 3 3 1 1 1 3
3 0 3 3 3 0 0 0 0 0 0 3 3 1 1 1 3
3 0 0 0 0 0 3 0 3 3 0 3 3 1 1 1 3
3 3 3 3 3 0 0 0 3 3 0 3 3 1 1 1 3
0 0 0 0 3 3 3 3 3 0 0 0 0 0 3 3 3
0 0 0 0 0 0 0 0 3 0 0 0 0 0 3 0 0
0 0 0 0 0 0 0 0 3 3 3 3 3 3 3 0 0
