8 11

6
2 5
3 7
4 5
4 7
7 2
7 5

11 19
0 0 0 0 3 3 3 3 3 0 0 0 0 0 0 0 0 0 0
0 0 0 0 3 0 0 0 3 0 0 0 0 0 0 0 0 0 0
0 0 0 0 3 0 0 0 3 0 0 0 0 0 0 0 0 0 0
0 0 3 3 3 0 0 0 3 3 0 0 0 0 0 0 0 0 0
0 0 3 0 0 0 0 0 0 3 0 0 0 0 0 0 0 0 0
3 3 3 0 3 0 3 3 0 3 0 0 0 3 3 3 3 3 3
3 0 0 0 3 0 3 3 0 3 3 3 3 3 0 0 1 1 3
3 0 0 0 0 0 0 0 0 0 0 0 0 0 0 0 1 1 3
3 3 3 3 3 0 3 3 3 0 3 0 3 3 0 0 1 1 3
0 0 0 0 3 0 0 0 0 0 3 3 3 3 3 3 3 3 3
0 0 0 3 3 3 3 3 3 3 3 0 0 0 0 0 0 0 0
