4 7

10
2 7
2 10
3 6
5 10
6 9
6 11
7 4
7 7
7 9
7 11

10 14
3 3 3 3 3 3 3 3 3 3 3 3 0 0
3 1 1 0 0 3 0 0 0 0 0 3 3 3
3 1 1 0 0 3 0 0 0 0 0 0 0 3
3 1 1 0 0 3 0 3 3 3 3 0 0 3
3 1 1 0 0 0 0 0 0 3 3 0 0 3
3 1 1 0 0 3 0 3 0 0 0 0 3 3
3 3 3 3 3 3 0 3 3 0 0 0 0 3
0 0 3 0 0 0 0 0 0 0 0 0 0 3
0 0 3 0 0 0 0 3 0 0 0 0 0 3
0 0 3 3 3 3 3 3 3 3 3 3 3 3
