1 14

11
2 10
2 12
3 10
3 13
4 10
4 12
5 10
6 10
6 13
7 9
7 12

10 17
0 0 0 0 0 0 0 0 3 3 3 3 3 3 3 3 0
0 0 0 0 0 0 0 0 3 0 0 0 0 0 0 3 0
0 0 0 0 0 0 0 0 3 0 0 3 0 0 3 3 0
0 0 0 0 0 0 0 0 3 0 0 0 0 0 3 0 0
0 0 0 0 0 0 0 0 3 3 0 0 0 0 3 0 0
3 3 3 3 3 3 3 3 3 0 0 0 3 0 3 3 3
3 1 1 1 1 0 0 3 3 0 0 0 0 0 0 0 3
3 3 1 1 1 0 0 0 0 0 0 0 0 0 0 0 3
3 1 1 1 1 0 0 3 3 3 3 3 3 3 3 3 3
3 3 3 3 3 3 3 3 0 0 0 0 0 0 0 0 0
