11 10

20
3 8
3 10
4 2
4 3
4 4
4 6
4 9
5 3
5 9
6 2
6 3
6 6
6 8
6 10
7 3
10 6
11 3
11 4
11 6
11 7

14 19
0 0 0 0 0 0 0 0 0 0 0 3 3 3 3 3 3 3 3
0 0 0 0 0 0 0 0 0 0 0 3 0 0 1 1 1 1 3
3 3 3 3 3 3 3 3 3 3 3 3 0 0 1 1 1 1 3
3 0 0 0 0 3 0 0 0 0 0 0 0 0 1 1 1 1 3
3 0 0 0 0 3 0 0 0 0 0 3 0 0 1 1 1 1 3
3 0 0 0 0 0 0 0 0 0 0 3 0 0 1 1 1 1 3
3 0 0 0 0 3 0 0 0 0 0 3 3 3 3 3 3 3 3
3 0 0 0 0 3 0 0 0 0 0 3 0 0 0 0 0 0 0
3 3 0 3 3 3 3 3 3 3 3 3 0 0 0 0 0 0 0
3 0 0 0 0 3 0 0 0 0 3 3 0 0 0 0 0 0 0
3 0 0 0 0 0 0 0 0 0 3 3 0 0 0 0 0 0 0
3 0 0 0 0 3 0 0 0 0 0 3 0 0 0 0 0 0 0
3 0 0 0 0 3 0 0 0 0 3 3 0 0 0 0 0 0 0
3 3 3 3 3 3 3 3 3 3 3 0 0 0 0 0 0 0 0
