7 14

12
2 11
3 14
5 10
5 13
6 9
6 11
6 12
7 9
7 12
8 11
9 10
9 12

13 17
0 0 0 0 0 0 0 0 3 3 3 3 3 0 0 0 0
0 0 0 0 0 0 0 0 3 0 0 0 3 3 3 3 3
0 0 0 0 0 0 0 0 3 0 3 0 3 3 0 0 3
0 0 0 0 0 0 0 0 3 0 0 0 0 0 0 0 3
3 3 3 3 3 3 3 3 3 0 3 3 3 0 0 0 3
3 1 1 1 1 0 0 3 3 0 0 0 0 0 3 3 3
3 1 1 1 1 0 0 0 0 0 0 0 0 0 3 3 0
3 1 1 1 1 0 0 3 3 0 0 0 0 0 0 3 0
3 3 3 3 3 3 3 3 3 0 0 0 0 0 3 3 0
0 0 0 0 0 0 0 0 3 0 0 0 0 0 0 3 0
0 0 0 0 0 0 0 0 3 3 3 0 3 3 0 3 0
0 0 0 0 0 0 0 0 0 0 3 0 0 0 0 3 0
0 0 0 0 0 0 0 0 0 0 3 3 3 3 3 3 0
