1 9

10
3 8
3 9
4 9
5 9
6 5
6 8
7 6
7 9
8 5
8 8

11 12
3 3 3 3 3 3 0 0 3 3 3 0
3 1 1 0 0 3 0 3 3 0 3 3
3 1 1 0 0 3 3 3 0 0 0 3
3 1 1 0 0 0 0 0 0 0 0 3
3 1 1 0 0 3 0 3 0 0 0 3
3 1 1 3 3 3 0 3 0 0 0 3
3 3 3 3 0 0 0 3 0 0 0 3
0 0 0 3 0 0 0 3 0 0 0 3
0 0 0 3 0 0 0 0 0 0 0 3
0 0 0 3 0 0 3 3 0 0 0 3
0 0 0 3 3 3 3 3 3 3 3 3
