2 5

11
2 9
2 10
3 5
4 3
5 9
6 2
7 2
7 4
7 6
9 2
9 3

12 13
0 0 0 0 0 0 0 3 3 3 3 3 0
0 3 3 3 3 3 3 3 0 0 0 3 3
3 3 0 3 0 0 3 3 0 0 0 0 3
3 0 0 0 0 0 0 0 0 0 0 0 3
3 0 0 0 0 0 3 3 3 0 0 0 3
3 3 3 0 3 3 3 3 3 0 3 3 3
3 0 0 0 0 3 3 3 0 1 1 3 0
3 0 0 0 0 0 0 0 1 1 1 3 0
3 0 0 0 0 3 3 3 1 1 1 3 0
3 0 0 0 0 3 0 3 1 1 1 3 0
3 0 0 3 3 3 0 3 3 3 3 3 0
3 3 3 3 0 0 0 0 0 0 0 0 0
