6 1

18
2 7
2 11
2 13
3 4
3 7
3 12
4 5
4 7
5 4
6 3
6 5
6 7
7 5
7 8
8 4
8 9
8 11
8 13

16 16
0 0 3 3 3 3 0 0 0 0 0 0 0 0 0 0
0 0 3 0 0 3 3 3 3 3 3 3 3 3 3 3
0 0 3 0 0 0 0 0 0 0 0 0 0 0 0 3
0 0 3 0 0 3 0 0 0 3 0 0 0 0 0 3
0 0 3 0 0 0 0 0 0 0 3 0 0 0 0 3
3 3 3 0 0 3 0 3 0 0 3 3 3 3 0 3
3 0 3 0 0 0 0 0 0 0 3 3 0 0 0 3
3 0 0 0 0 0 0 3 0 3 0 0 0 3 0 3
3 0 0 0 0 0 0 0 0 0 0 0 0 0 0 3
3 3 3 3 3 0 0 3 3 3 3 3 3 3 3 3
0 0 3 0 0 0 0 0 0 3 0 0 0 0 0 0
0 0 3 0 0 0 0 0 0 3 0 0 0 0 0 0
0 0 3 1 1 1 1 1 1 3 0 0 0 0 0 0
0 0 3 1 1 1 1 1 1 3 0 0 0 0 0 0
0 0 3 1 1 1 1 1 1 3 0 0 0 0 0 0
0 0 3 3 3 3 3 3 3 3 0 0 0 0 0 0
