10 1

14
7 7
7 8
7 9
8 8
8 10
9 6
9 8
10 3
10 6
10 11
10 14
11 7
11 8
11 10

14 17
0 0 0 0 0 0 0 0 0 0 3 3 3 3 3 3 3
0 0 0 0 0 0 0 0 0 0 3 0 0 1 1 1 3
0 0 0 0 0 0 3 3 3 3 3 0 0 1 1 1 3
0 0 0 0 0 0 3 0 0 0 0 0 0 1 0 1 3
0 0 0 0 0 0 3 0 0 3 3 0 0 1 1 1 3
0 0 0 0 0 0 3 3 0 3 3 0 0 1 1 1 3
0 0 0 0 0 3 3 3 0 3 3 3 3 3 3 3 3
0 0 0 0 0 3 0 0 0 0 0 3 3 0 0 0 0
0 3 3 3 3 3 0 0 0 0 0 0 3 3 3 3 3
3 3 0 0 0 3 0 0 0 0 0 0 3 0 0 0 3
3 0 0 0 0 0 0 0 0 0 0 0 0 0 0 0 3
3 3 3 3 3 3 0 0 0 0 0 0 3 3 3 3 3
0 0 0 0 0 3 0 0 0 0 0 0 3 0 0 0 0
0 0 0 0 0 3 3 3 3 3 3 3 3 0 0 0 0
