10
10
XXXXXXXXXX
X........X
X......-.X
X........X
X...X....X
X....X...X
X........X
X.-......X
X........X
XXXXXXXXXX
